NO ./imgs/wall_NO.png
SO ./imgs/wall_S.png
WE ./imgs/wall_W.png
EA ./imgs/dam.png



C 00,150,255
F 255,255,255

1111111111111111111111111
1000000000110000000000001
1011000001110000000000001
1001000000000000000000001
1111111110110000011100001
100000000011000001110111111111111
11110111111111011100000010001
11110111111111011101010010001
11000000110101011100000000001
10000E00000000001100000000001
1000000000000001101010000001
1100000111010101111101111000111
11110111 1110101 101111010001
11111111 1111111 111111111111