00000000
01111110
01001110
01110110
01100N10
01111110
00000000