NO /Users/zouaraqa/Desktop/imgs/down.png 
SO /Users/zouaraqa/Desktop/imgs/up.pnp
WE /Users/zouaraqa/Desktop/imgs/left.png
EA /Users/zouaraqa/Desktop/imgs/right.png


F 220,   100    , 1
C 225,30,0




11111111111111111111111111111111111111111
100000000000000000000000000000000001
1N00000000000000000000000000000001111
1000000000000000000000000000000001111
111111111111111111111111111111111111