NO /Users/zouaraqa/Desktop/imgs/down.png 
SO /Users/zouaraqa/Desktop/imgs/up.pnp
WE /Users/zouaraqa/Desktop/imgs/left.png
EA /Users/zouaraqa/Desktop/imgs/right.png


F 220,   100    , 1
C 225,30,0


        111111111
        1001
        1N11
1111111111111111111111111111111111111111111111111111
		
