NO ./imgs/wall.png    
SO ./imgs/wall.png
WE ./imgs/wall.png
EA ./imgs/wall.png


F 220,   100    , 1
C 225,30,0




1111111111
100001
100001111    
1000001111
11111111
          1
         1W1
          1