NO    ./imgs/wall_NO.png
SO ./imgs/wall_S.png
WE ./imgs/wall_W.png
EA ./imgs/dam.png
F 20,50,6
C 20,10,70




111   111   111
101   101   101
101   101111101
1E1   100000001
101   101111101
101   101   101
101   101   101
1011111011111011
1000000000000001
1011111111111111
101
101
101
101
101
111