NO /Users/zouaraqa/Desktop/imgs/down.png 
SO /Users/zouaraqa/Desktop/imgs/up.pnp
WE /Users/zouaraqa/Desktop/imgs/left.png
EA /Users/zouaraqa/Desktop/imgs/right.png


F 220,   100    , 1
C 225,30,0



1111111111
10001
10E111
10101
1111111