NO ./imgs/wall.png
SO ./imgs/wall.png
WE ./imgs/wall.png
EA ./imgs/wall.png


F 20,50,6
C 20,10,70
		

1111111111111111111111111111111111111111111111111111111111111111111111111111111111111
100000000000000000000000000000000000000000000000000000000000000000000000001
1000000000000000000000000000000000000000000000000000000000000000000000000001
100000000000000000000000000000000000000000000000000000000000000000000000001
1000000000000000000000000000000000010000001111100000000000000000000000000001
100000000000000000000000000000000000000001     1000000000000000000000000001
100000000000111111110000000000000000000001     1000000000000000000000000001
1000000000001      10000000000000000000001     1000000000000000000000000001
100000000000111111110000000000000000000001     10000000000000000000000000001
100000000000000000000000000011000000000001     1000000000000000000000000001
100000000000000000000000000000000000000001     1000000000000000000000000001
100000000000000000000000000000000001000001     1000000000000000000000000001
10000000000000000000000000000000001E0000001111100000000000000000000000000001
1000000000000000000000000000000000010000000000000000000000000000000000000111
1000000000000000000000000000000000000000000000000000000000000000000000000001
1000000000000000000000000001000000000000000000000100000000000000000000000001
1000000000000000000000000000000000000000000000000000000000000000000000000001
1000000000000000000000000000000000000000000000000000000000000000000000000001
1000000000000000000000000000000000000000000000000000000000000000000000000111
1000000000000000000000000000000000010000000000000000000000000000000000000111
1000000000000000000000000000000000000000000000000000000000000000000000000001
1000000000000000000000000001000000000000000000000100000000000000000000000001
1000000000000000000000000000000000000000000000000000000000000000000000000001
1000000000000000000000000000000000000000000000000000000000000000000000000001
1000000000000000000000000000000000000000000000000000000000000000000000000111
1000000000000000000000000000000000010000000000000000000000000000000000000111
1000000000000000000000000000000000000000000000000000000000000000000000000001
1000000000000000000000000001000000000000000000000100000000000000000000000001
1000000000000000000000000000000000000000000000000000000000000000000000000001
1000000000000000000000000000000000000000000000000000000000000000000000000001
1000000000000000000000000000000000000000000000000000000000000000000000000111
1000000000000000000000000000000000010000000000000000000000000000000000000111
1000000000000000000000000000000000000000000000000000000000000000000000000001
1000000000000000000000000001000000000000000000000100000000000000000000000001
1000000000000000000000000000000000000000000000000000000000000000000000000001
1000000000000000000000000000000000000000000000000000000000000000000000000001
1000000000000000000000000000000000000000000000000000000000000000000000000111
1000000000000000000000000000000000010000000000000000000000000000000000000111
1000000000000000000000000000000000000000000000000000000000000000000000000001
1000000000000000000000000001000000000000000000000100000000000000000000000001
1000000000000000000000000000000000000000000000000000000000000000000000000001
1000000000000000000000000000000000000000000000000000000000000000000000000001
1000000000000000000000000000000000000000000000000000000000000000000000000111
1000000000000000000000000000000000010000000000000000000000000000000000000111
1000000000000000000000000000000000000000000000000000000000000000000000000001
1000000000000000000000000001000000000000000000000100000000000000000000000001
1000000000000000000000000000000000000000000000000000000000000000000000000001
1000000000000000000000000000000000000000000000000000000000000000000000000001
1000000000000000000000000000000000000000000000000000000000000000000000000111
1000000000000000000000000000000000010000000000000000000000000000000000000111
1000000000000000000000000000000000000000000000000000000000000000000000000001
1000000000000000000000000001000000000000000000000100000000000000000000000001
1000000000000000000000000000000000000000000000000000000000000000000000000001
1000000000000000000000000000000000000000000000000000000000000000000000000001
1000000000000000000000000000000000000000000000000000000000000000000000000111
1000000000000000000000000000000000010000000000000000000000000000000000000111
1000000000000000000000000000000000000000000000000000000000000000000000000001
1000000000000000000000000001000000000000000000000100000000000000000000000001
1000000000000000000000000000000000000000000000000000000000000000000000000001
1000000000000000000000000000000000000000000000000000000000000000000000000001
1000000000000000000000000000000000000000000000000000000000000000000000000111
1000000000000000000000000000000000010000000000000000000000000000000000000111
1000000000000000000000000000000000000000000000000000000000000000000000000001
1000000000000000000000000001000000000000000000000100000000000000000000000001
1000000000000000000000000000000000000000000000000000000000000000000000000001
1000000000000000000000000000000000000000000000000000000000000000000000000001
1000000000000000000000000000000000000000000000000000000000000000000000000111
1000000000000000000000000000000000010000000000000000000000000000000000000111
1000000000000000000000000000000000000000000000000000000000000000000000000001
1000000000000000000000000001000000000000000000000100000000000000000000000001
1000000000000000000000000000000000000000000000000000000000000000000000000001
1000000000000000000000000000000000000000000000000000000000000000000000000001
1000000000000000000000000000000000000000000000000000000000000000000000000111
1000000000000000000000000000000000010000000000000000000000000000000000000111
1000000000000000000000000000000000000000000000000000000000000000000000000001
1000000000000000000000000001000000000000000000000100000000000000000000000001
1000000000000000000000000000000000000000000000000000000000000000000000000001
1000000000000000000000000000000000000000000000000000000000000000000000000001
1000000000000000000000000000000000000000000000000000000000000000000000000111
1000000000000000000000000000000000010000000000000000000000000000000000000111
1000000000000000000000000000000000000000000000000000000000000000000000000001
1000000000000000000000000001000000000000000000000100000000000000000000000001
1000000000000000000000000000000000000000000000000000000000000000000000000001
1000000000000000000000000000000000000000000000000000000000000000000000000001
1000000000000000000000000000000000000000000000000000000000000000000000000111
1000000000000000000000000000000000010000000000000000000000000000000000000111
1000000000000000000000000000000000000000000000000000000000000000000000000001
1000000000000000000000000001000000000000000000000100000000000000000000000001
1000000000000000000000000000000000000000000000000000000000000000000000000001
1000000000000000000000000000000000000000000000000000000000000000000000000001
1000000000000000000000000000000000000000000000000000000000000000000000000111
1000000000000000000000000000000000010000000000000000000000000000000000000111
1000000000000000000000000000000000000000000000000000000000000000000000000001
1000000000000000000000000001000000000000000000000100000000000000000000000001
1000000000000000000000000000000000000000000000000000000000000000000000000001
1000000000000000000000000000000000000000000000000000000000000000000000000001
1000000000000000000000000000000000000000000000000000000000000000000000000111
1000000000000000000000000000000000010000000000000000000000000000000000000111
1000000000000000000000000000000000000000000000000000000000000000000000000001
1000000000000000000000000001000000000000000000000100000000000000000000000001
1000000000000000000000000000000000000000000000000000000000000000000000000001
1000000000000000000000000000000000000000000000000000000000000000000000000001
1000000000000000000000000000000000000000000000000000000000000000000000000111
1000000000000000000000000000000000010000000000000000000000000000000000000111
1000000000000000000000000000000000000000000000000000000000000000000000000001
1000000000000000000000000001000000000000000000000100000000000000000000000001
1000000000000000000000000000000000000000000000000000000000000000000000000001
1000000000000000000000000000000000000000000000000000000000000000000000000001
1000000000000000000000000000000000000000000000000000000000000000000000000111
1000000000000000000000000000000000010000000000000000000000000000000000000111
1000000000000000000000000000000000000000000000000000000000000000000000000001
1000000000000000000000000001000000000000000000000100000000000000000000000001
1000000000000000000000000000000000000000000000000000000000000000000000000001
1000000000000000000000000000000000000000000000000000000000000000000000000001
1000000000000000000000000000000000000000000000000000000000000000000000000111
1000000000000000000000000000000000010000000000000000000000000000000000000111
1000000000000000000000000000000000000000000000000000000000000000000000000001
1000000000000000000000000001000000000000000000000100000000000000000000000001
1000000000000000000000000000000000000000000000000000000000000000000000000001
1000000000000000000000000000000000000000000000000000000000000000000000000001
1000000000000000000000000000000000000000000000000000000000000000000000000111
1000000000000000000000000000000000010000000000000000000000000000000000000111
1000000000000000000000000000000000000000000000000000000000000000000000000001
1000000000000000000000000001000000000000000000000100000000000000000000000001
1000000000000000000000000000000000000000000000000000000000000000000000000001
1000000000000000000000000000000000000000000000000000000000000000000000000001
1000000000000000000000000000000000000000000000000000000000000000000000000111
1000000000000000000000000000000000010000000000000000000000000000000000000111
1000000000000000000000000000000000000000000000000000000000000000000000000001
1000000000000000000000000001000000000000000000000100000000000000000000000001
1000000000000000000000000000000000000000000000000000000000000000000000000001
1000000000000000000000000000000000000000000000000000000000000000000000000001
1000000000000000000000000000000000000000000000000000000000000000000000000111
1000000000000000000000000000000000010000000000000000000000000000000000000111
1000000000000000000000000000000000000000000000000000000000000000000000000001
1000000000000000000000000001000000000000000000000100000000000000000000000001
1000000000000000000000000000000000000000000000000000000000000000000000000001
1000000000000000000000000000000000000000000000000000000000000000000000000001
1000000000000000000000000000000000000000000000000000000000000000000000000111
1000000000000000000000000000000000010000000000000000000000000000000000000111
1000000000000000000000000000000000000000000000000000000000000000000000000001
1000000000000000000000000001000000000000000000000100000000000000000000000001
1000000000000000000000000000000000000000000000000000000000000000000000000001
1000000000000000000000000000000000000000000000000000000000000000000000000001
1000000000000000000000000000000000000000000000000000000000000000000000000111
1000000000000000000000000000000000010000000000000000000000000000000000000111
1000000000000000000000000000000000000000000000000000000000000000000000000001
1000000000000000000000000001000000000000000000000100000000000000000000000001
1000000000000000000000000000000000000000000000000000000000000000000000000001
1000000000000000000000000000000000000000000000000000000000000000000000000001
1000000000000000000000000000000000000000000000000000000000000000000000000111
1000000000000000000000000000000000010000000000000000000000000000000000000111
1000000000000000000000000000000000000000000000000000000000000000000000000001
1000000000000000000000000001000000000000000000000100000000000000000000000001
1000000000000000000000000000000000000000000000000000000000000000000000000001
1000000000000000000000000000000000000000000000000000000000000000000000000001
1000000000000000000000000000000000000000000000000000000000000000000000000111
1000000000000000000000000000000000010000000000000000000000000000000000000111
1000000000000000000000000000000000000000000000000000000000000000000000000001
1000000000000000000000000001000000000000000000000100000000000000000000000001
1000000000000000000000000000000000000000000000000000000000000000000000000001
1000000000000000000000000000000000000000000000000000000000000000000000000001
1000000000000000000000000000000000000000000000000000000000000000000000000111
1000000000000000000000000000000000010000000000000000000000000000000000000111
1000000000000000000000000000000000000000000000000000000000000000000000000001
1000000000000000000000000001000000000000000000000100000000000000000000000001
1000000000000000000000000000000000000000000000000000000000000000000000000001
1000000000000000000000000000000000000000000000000000000000000000000000000001
1000000000000000000000000000000000000000000000000000000000000000000000000111
1000000000000000000000000000000000010000000000000000000000000000000000000111
1000000000000000000000000000000000000000000000000000000000000000000000000001
1000000000000000000000000001000000000000000000000100000000000000000000000001
1000000000000000000000000000000000000000000000000000000000000000000000000001
1000000000000000000000000000000000000000000000000000000000000000000000000001
1000000000000000000000000000000000000000000000000000000000000000000000000111
1000000000000000000000000000000000010000000000000000000000000000000000000111
1000000000000000000000000000000000000000000000000000000000000000000000000001
1000000000000000000000000001000000000000000000000100000000000000000000000001
1000000000000000000000000000000000000000000000000000000000000000000000000001
1000000000000000000000000000000000000000000000000000000000000000000000000001
1000000000000000000000000000000000000000000000000000000000000000000000000111
1000000000000000000000000000000000010000000000000000000000000000000000000111
1000000000000000000000000000000000000000000000000000000000000000000000000001
1000000000000000000000000001000000000000000000000100000000000000000000000001
1000000000000000000000000000000000000000000000000000000000000000000000000001
1000000000000000000000000000000000000000000000000000000000000000000000000001
1000000000000000000000000000000000000000000000000000000000000000000000000111
1000000000000000000000000000000000010000000000000000000000000000000000000111
1000000000000000000000000000000000000000000000000000000000000000000000000001
1000000000000000000000000001000000000000000000000100000000000000000000000001
1000000000000000000000000000000000000000000000000000000000000000000000000001
1000000000000000000000000000000000000000000000000000000000000000000000000001
1000000000000000000000000000000000000000000000000000000000000000000000000111
1000000000000000000000000000000000010000000000000000000000000000000000000111
1000000000000000000000000000000000000000000000000000000000000000000000000001
1000000000000000000000000001000000000000000000000100000000000000000000000001
1000000000000000000000000000000000000000000000000000000000000000000000000001
1000000000000000000000000000000000000000000000000000000000000000000000000001
1000000000000000000000000000000000000000000000000000000000000000000000000111
1000000000000000000000000000000000010000000000000000000000000000000000000111
1000000000000000000000000000000000000000000000000000000000000000000000000001
1000000000000000000000000001000000000000000000000100000000000000000000000001
1000000000000000000000000000000000000000000000000000000000000000000000000001
1000000000000000000000000000000000000000000000000000000000000000000000000001
1000000000000000000000000000000000000000000000000000000000000000000000000111
1000000000000000000000000000000000010000000000000000000000000000000000000111
1000000000000000000000000000000000000000000000000000000000000000000000000001
1000000000000000000000000001000000000000000000000100000000000000000000000001
1000000000000000000000000000000000000000000000000000000000000000000000000001
1000000000000000000000000000000000000000000000000000000000000000000000000001
1000000000000000000000000000000000000000000000000000000000000000000000000111
1000000000000000000000000000000000010000000000000000000000000000000000000111
1000000000000000000000000000000000000000000000000000000000000000000000000001
1000000000000000000000000001000000000000000000000100000000000000000000000001
1000000000000000000000000000000000000000000000000000000000000000000000000001
1000000000000000000000000000000000000000000000000000000000000000000000000001
1000000000000000000000000000000000000000000000000000000000000000000000000111
10000000000000000000000000000000000000000000000000000000000000000000000001 1
11111111111111111111111111111111111111111111111111111111111111111111111111111111111111111111111111111111111
10101
1111111
11111